type octile
height 83
width 68
map
....................................................TT@@@@@@@@@@@@@@
...........TTTTTTTTTTT@@@@@@@@@@@@@@@@TT............TT@@@@@@@@@@@@@@
............TTT@@@@@@T@@@@@@@@@@@@@@@@TT.............T@@@@@@@@@@@@@@
............TT@@@@@@@@@@@@@@@@@@@@@@@@T...............@@@@@@@@@@@@@@
...........TT@@@@@@@@@@@@@@@@@@@@@@@@@T...............@@@@@@@@@@@@@@
...........TT@@@@@@@@@@@@@@@@@@@@@@@@@T...............@@@@@@@@@@@@@@
..........TTT@@@@@@@@@@@@@@@@@@@@@@@@@T...............@@@@@@@@@@@@@@
..........TT@@@@@@@@@@@@@@@@@@@@@@@@@@T...............@@@@@@@@@@@@@@
.........TTT@@@@@@@@@@@@@@@@@@@@@@@@@@T...............@@@@@@@@@@@@@@
.......TTTT@@@@@@@@@@@@@@@@@@@@@@@@@@@T...............@@@@@@@@@@@@@@
...TTTTTT@T@@@@@@@@@@@@@@@@@@@@@@@@@@@T...............@@@@@@@@@@@@@@
..TTTTTT@@@@@@@@@@@@@@@@@@@@@@@@@@@@@@T...............@@@@@@@@@@@@@@
..TTTTT@@@@@@@@@@@@@@@@@@@@@@@@@@@@@@@T...............@@@@@@@@@@@@@@
..TTTT@@@@@@@@@@@@@@@@@@@@@@@@@@@@@@@@T...............@@@@@@@@@@@@@@
TTTT@@@@@@@@@@@@@@@@@@@@@@@@@@@@@@@@@@T...............@@@@@@@@@@@@@@
TT@@@@@@@@@@@@@@@@@@@@@@@@@@@@@@@@@@@@TT.............T@@@@@@@@@@@@@@
T@@@@@@@@@@@@@@@@@@@@@@@@@@@@@@@@@@@@@TT............TTTTTTTTTTTTTTTT
@@@@@@@@@@@@@@@@@@@@@@@@@@@@@@@@@@@@@@TT............TTTTTTTTTTTTTTTT
@@@@@@@@@@@@@@@@@@@@@@@@@@@@@@@@@@@@@@TT.............TTT............
@@@@@@@@@@@@@@@@@@@@@@@@@@@@@@@@@@@@@@T.............................
@@@@@@@@@@@@@@@@@@@@@@@@@@@@@@@@@@@@@@T.............................
@@@@@@@@@@@@@@@@@@@@@@@@@@@@@@@@@@@@@@T.............................
@@@@@@@@@@@@@@@@@@@@@@@@@@@@@@@@@@@@@@T.............................
@@@@@@@@@@@@@@@@@@@@@@@@@@@@@@@@@@@@@@T.............................
@@@@@@@@@@@@@@@@@@@@@@@@@@@@@@@@@@@@@@T.............................
@@@@@@@@@@@@@@@@@@@@@@@@@@@@@@@@@@@@@@T.............................
@@@@@@@@@@@@@@@@@@@@@@@@@@@@@@@@@@@@@@T.............................
@@@@@@@@@@@@@@@@@@@@@@@@@@@@@@@@@@@@@@T.............................
@@@@@@@@@@@@@@@@@@@@@@@@@@@@@@@@@@@@@@T.............................
@@@@@@@@@@@@@@@@@@@@@@@@@@@@@@@@@@@@@@T.............................
@@@@@@@@@@@@@@@@@@@@@@@@@@@@@@@@@@@@@@T.............................
@@@@@@@@@@@@@@@@@@@@@@@@@@@@@@@@@@@@@@TT............................
@@@@@@TTTTTTTTTTTTTTTTTTTTTTTTTTTTTTTTTT............................
@@@@@@TTTTTTTTTTTTTTTTTTTTTTTTTTTTTTTTTT............................
@@@@@@TT.............TTT.............TTT............................
@@@@@@T.............................................................
@@@@@@T.............................................................
@@@@@@T.............................................................
@@@@@@T.............................................................
@@@@@@T.............................................................
@@@@@@T.............................................................
@@@@@@T.............................................................
@@@@@@T.............................................................
@@@@@@T.............................................................
@@@@@@T.............................................................
@@@@@@T.............................................................
@@@@@@T.............................................................
@@@@@@TT.............................TTT.............TTT............
@@@@@@TT............................TTTTTTTTTTTTTTTTTTTTTTTTTTTTTTTT
@@@@@@TT............................TT@@@@@@@@@@@@@@@@@@@@@@@@@@@@@@
@@@@@@TT.............................T@@@@@@@@@@@@@@@@@@@@@@@@@@@@@@
@@@@@@T...............................@@@@@@@@@@@@@@@@@@@@@@@@@@@@@@
@@@@@@T...............................@@@@@@@@@@@@@@@@@@@@@@@@@@@@@@
@@@@@@T...............................@@@@@@@@@@@@@@@@@@@@@@@@@@@@@@
@@@@@@T...............................@@@@@@@@@@@@@@@@@@@@@@@@@@@@@@
@@@@@@T...............................@@@@@@@@@@@@@@@@@@@@@@@@@@@@@@
@@@@@@T...............................@@@@@@@@@@@@@@@@@@@@@@@@@@@@@@
@@@@@@T...............................@@@@@@@@@@@@@@@@@@@@@@@@@@@@@@
@@@@@@T...............................@@@@@@@@@@@@@@@@@@@@@@@@@@@@@@
@@@@@@T...............................@@@@@@@@@@@@@@@@@@@@@@@@@@@@@@
@@@@@@T...............................@@@@@@@@@@@@@@@@@@@@@@@@@@@@@@
@@@@@@T...............................@@@@@@@@@@@@@@@@@@@@@@@@@@@@@@
@@@@@@T...............................@@@@@@@@@@@@@@@@@@@@@@@@@@@@@@
@@@@@@TT.............................T@@@@@@@@@@@@@@@@@@@@@@@@@@@@@@
@@@@@@TT............................TTTTTTTTTTTTTTTTTTTTTTTTTTTTTTTT
@@@@@@TT............................TTTTTTTTTTTTTTTTTTTTTTTTTTTTTTTT
@@@@@@TT.............................TTT.............TTT............
@@@@@@T.............................................................
@@@@@@T.............................................................
@@@@@@T.............................................................
@@@@@@T.............................................................
@@@@@@T.............................................................
@@@@@@T.............................................................
@@@@@@T.............................................................
@@@@@@T.............................................................
@@@@@@T.............................................................
@@@@@@T.............................................................
@@@@@@T.............................................................
@@@@@@T.............................................................
@@@@@@TT.............TTT............................................
@@@@@@TTTTTTTTTTTTTTTTTT............................................
@@@@@@@@@@@@@@@@@@@@@@TT............................................
@@@@@@@@@@@@@@@@@@@@@@TT............................................