type octile
height 37
width 62
map
TTTTTTTTTTTTTTTTT@@@@@@@@@@@@@@@@@@@@@@@@@@@@@@@@@@@@@@@@@@@@@
TTTTTT.....TTTTTT@@@@@@@@@@@@@@@@@@@@@@@@@@@@@@@@@@@@@@@@@@@@@
TTTTTT.....TTTTTT@@@@@@@@@@@@@@@@@@@@@@@@@@@@@@@@@@@@@@@@@@@@@
TTTTTTT....TTTTTT@@@@@@@@@TTTTTTTTTTTTTTTTTTTTTTTTTTTTTTT@@@@@
TTTTTTTT.....TTTT@@@@@@@@@TTTTTTTTTTTTTTTTTTTTTTTTTTTTTTT@@@@@
TTTTTTT.......TTTTTTTT..TTTTTT...TTTTTTT......TTTTTTTT.TT@@@@@
TTTTTT..........TTTTTT..TTTTTT.....TTTT.......TTTTTTTT.TT@@@@@
TT@@TT........................................TTTTTTTT.TT@@@@@
TT@@TT........................................TTTTTTTT.TT@@@@@
TT@@T.........................................TTTTTTTT..T@@@@@
TTT@T........TT..........................T....TTTTTTTT..T@@@@@
TTT@TT......TTTTT...........T...........TTT.............TTTTT@
TTT@TT.....TTTTTTT.........TTTTT......TTTTTT.............TTTTT
TTTTTT.....TTTTTTT........TTTTTT......T@TTTT.............TTTTT
TTTTTT....TTTTTTTT.........TTTTT......T@TTT...............TTTT
TTTTTT....TTTTTTT.........TTTTTT......T@TT............T...TTTT
TTTTTT...TTTTTTT..........T@@@TT......T@TTT...........TTT.TTTT
TTTTTT.....TTTT...........TTTTT.......TTTTT..........TTTTTTTTT
TTTTTT......TTT............T............TTT..........TTTTTTTTT
TTTTTT..............................................TTTTTTTTT@
TT....................................................TTTTTTTT
TT.........................TT..........................TTTTTTT
TT..........TTTT...........TTT...........................TTTTT
TT.........TTTTTT........TTTTTT.......TTTTTT................TT
TT.........TTTTTT........T@@@@T.......T@@@@TTT..............TT
TT.........TTTTTT........TTTTTTT......TTTTTTTTT.............TT
TT..........TTTTTT........TTTTTT........TTTTTT..............TT
TTTTT.......TTTTTT........TTTTT.........TT@TTT..........TTTTT@
@TTTTT......TTTTTT.......................TT@TT..........T@@@@@
@TTTTTT......TTTTT........................TTT.........TTT@@@@@
@TTTTTT......TT.......................................TTT@@@@@
@TTTTTT.................TTTTTTTT....................TTTTT@@@@@
@@@@@TTT..............TTTTTTTTTTT.............TT.TT.TTTTT@@@@@
@@@@@TTT............TTTTTTTTTTTTT........TTTTTTTTTTTTTTTT@@@@@
@@@@@TTTTT........TTTTTTTTTTTTTTT........TTTTTTTTTTTTTTTT@@@@@
@@@@TTTTTTTTTTTTTTTTTTTTTTTTTTTTT...TTTTTTTTTTTTTTTTTTTTT@@@@@
@@@TTTTTTTTTTTTTTTTTTTTTTTTTTTTTTT..TTTTTTTTT@@@@@@@@@@@@@@@@@