type octile start 9,8 end 12,0
height 10
width 17
map
TT.............T@
TTTTTT.....TTTTTT
TTTTTT.....TTTTTT
TT.............TT
.................
.................
.................
.................
.................
.................